11111111111111111111111111111111
1-000000100000000000000000000001
10000000100000000000000000000001
10000000000000000000000000000001
10000000000000000001111111111111
11110000000000000001000000000001
10000000000000000000000000000001
10000000000000000000000000000001
10000000000000000000000000000001
10000011100000000000111111111111
10000001100000000000000000000001
10000000100000000000000000000001
10000000000000000000000000000001
11111110000011001111000000001111
10000000000000000000000000000001
10000000000000000000000000000001
10000000000000000000000001111111
10000000111110000000000000000101
10000000000000000000000000000001
1000000000*000000000000000000001
10000000000000000000000000000001
10000000000100000000000000000001
10000000000100000000000000000101
11111111111111111111111111111111